Signal Legend:

Key        Signal Name

0        = n_reset
1        = OneHotStateMachine:StateMachine|Pre_Q[0]
2        = OneHotStateMachine:StateMachine|Pre_Q[1]
3        = OneHotStateMachine:StateMachine|Pre_Q[2]
4        = OneHotStateMachine:StateMachine|Pre_Q[3]
5        = OneHotStateMachine:StateMachine|Pre_Q[4]
6        = OneHotStateMachine:StateMachine|Pre_Q[5]
7        = REG_32:InstructionROMDataOutputLatch|q[24]
8        = REG_32:InstructionROMDataOutputLatch|q[25]
9        = REG_32:InstructionROMDataOutputLatch|q[26]
10       = REG_32:InstructionROMDataOutputLatch|q[27]
11       = REG_32:InstructionROMDataOutputLatch|q[28]
12       = REG_32:InstructionROMDataOutputLatch|q[29]
13       = REG_32:InstructionROMDataOutputLatch|q[30]
14       = REG_32:InstructionROMDataOutputLatch|q[31]
15       = RegisterFile:RegisterFile|COUNT_32:r7|Pre_Q[0]~32
16       = RegisterFile:RegisterFile|COUNT_32:r7|Pre_Q[1]~34
17       = RegisterFile:RegisterFile|COUNT_32:r7|Pre_Q[2]~36
18       = RegisterFile:RegisterFile|COUNT_32:r7|Pre_Q[3]~38
19       = RegisterFile:RegisterFile|COUNT_32:r7|Pre_Q[4]~40
20       = RegisterFile:RegisterFile|COUNT_32:r7|Pre_Q[5]~42
21       = RegisterFile:RegisterFile|COUNT_32:r7|Pre_Q[6]~44
22       = RegisterFile:RegisterFile|COUNT_32:r7|Pre_Q[7]~46

Data Table:

Signals-> 0 1 2 3 4 5 6 7 8 9 10 11 12 13 14 15 16 17 18 19 20 21 22 

sample

-16       0 0 0 0 0 0 0 0 0 0 0  0  0  0  0  0  0  0  0  0  0  0  0  
-15       0 0 0 0 0 0 0 0 0 0 0  0  0  0  0  0  0  0  0  0  0  0  0  
-14       0 0 0 0 0 0 0 0 0 0 0  0  0  0  0  0  0  0  0  0  0  0  0  
-13       0 0 0 0 0 0 0 0 0 0 0  0  0  0  0  0  0  0  0  0  0  0  0  
-12       0 0 0 0 0 0 0 0 0 0 0  0  0  0  0  0  0  0  0  0  0  0  0  
-11       0 0 0 0 0 0 0 0 0 0 0  0  0  0  0  0  0  0  0  0  0  0  0  
-10       0 0 0 0 0 0 0 0 0 0 0  0  0  0  0  0  0  0  0  0  0  0  0  
-9        0 0 0 0 0 0 0 0 0 0 0  0  0  0  0  0  0  0  0  0  0  0  0  
-8        0 0 0 0 0 0 0 0 0 0 0  0  0  0  0  0  0  0  0  0  0  0  0  
-7        0 0 0 0 0 0 0 0 0 0 0  0  0  0  0  0  0  0  0  0  0  0  0  
-6        0 0 0 0 0 0 0 0 0 0 0  0  0  0  0  0  0  0  0  0  0  0  0  
-5        0 0 0 0 0 0 0 0 0 0 0  0  0  0  0  0  0  0  0  0  0  0  0  
-4        0 0 0 0 0 0 0 0 0 0 0  0  0  0  0  0  0  0  0  0  0  0  0  
-3        0 0 0 0 0 0 0 0 0 0 0  0  0  0  0  0  0  0  0  0  0  0  0  
-2        0 0 0 0 0 0 0 0 0 0 0  0  0  0  0  0  0  0  0  0  0  0  0  
-1        0 0 0 0 0 0 0 0 0 0 0  0  0  0  0  0  0  0  0  0  0  0  0  
0         1 0 0 0 0 0 0 0 0 0 0  0  0  0  0  0  0  0  0  0  0  0  0  
1         1 1 0 0 0 0 0 0 0 0 0  0  0  0  0  0  0  0  0  0  0  0  0  
2         1 0 1 0 0 0 0 0 0 0 0  0  0  0  0  0  0  0  0  0  0  0  0  
3         1 0 0 1 0 0 0 0 0 0 0  0  0  0  0  0  0  0  0  0  0  0  0  
4         1 0 0 0 1 0 0 0 0 0 0  0  0  0  0  0  0  0  0  0  0  0  0  
5         1 0 0 0 0 1 0 0 0 0 0  0  0  0  0  0  0  0  0  0  0  0  0  
6         1 0 0 0 0 0 1 0 0 0 0  0  0  0  0  1  0  0  0  0  0  0  0  
7         1 1 0 0 0 0 0 0 0 0 0  0  0  0  0  1  0  0  0  0  0  0  0  
8         1 0 1 0 0 0 0 0 0 0 0  0  0  0  0  1  0  0  0  0  0  0  0  
9         1 0 0 1 0 0 0 0 0 0 0  0  0  0  0  1  0  0  0  0  0  0  0  
10        1 0 0 0 1 0 0 0 0 0 0  0  0  0  0  1  0  0  0  0  0  0  0  
11        1 0 0 0 0 1 0 0 0 0 0  0  0  0  0  1  0  0  0  0  0  0  0  
12        1 0 0 0 0 0 1 0 0 0 0  0  0  0  0  0  1  0  0  0  0  0  0  
13        1 1 0 0 0 0 0 0 0 0 0  0  0  0  0  0  1  0  0  0  0  0  0  
14        1 0 1 0 0 0 0 0 0 0 0  0  0  0  0  0  1  0  0  0  0  0  0  
15        1 0 0 1 0 0 0 0 0 0 0  0  0  0  0  0  1  0  0  0  0  0  0  
16        1 0 0 0 1 0 0 0 0 0 0  0  0  0  0  0  1  0  0  0  0  0  0  
17        1 0 0 0 0 1 0 0 0 0 0  0  0  0  0  0  1  0  0  0  0  0  0  
18        1 0 0 0 0 0 1 0 0 0 0  0  0  0  0  1  1  0  0  0  0  0  0  
19        1 1 0 0 0 0 0 0 0 0 0  0  0  0  0  1  1  0  0  0  0  0  0  
20        1 0 1 0 0 0 0 0 0 0 0  0  0  0  0  1  1  0  0  0  0  0  0  
21        1 0 0 1 0 0 0 0 0 0 0  0  0  0  0  1  1  0  0  0  0  0  0  
22        1 0 0 0 1 0 0 0 0 0 0  0  1  0  0  1  1  0  0  0  0  0  0  
23        1 0 0 0 0 1 0 0 0 0 0  0  1  0  0  1  1  0  0  0  0  0  0  
24        1 0 0 0 0 0 1 0 0 0 0  0  1  0  0  0  0  1  0  0  0  0  0  
25        1 1 0 0 0 0 0 0 0 0 0  0  1  0  0  0  0  0  0  0  0  0  0  
26        1 0 1 0 0 0 0 0 0 0 0  0  1  0  0  0  0  0  0  0  0  0  0  
27        1 0 0 1 0 0 0 0 0 0 0  0  1  0  0  0  0  0  0  0  0  0  0  
28        1 0 0 0 1 0 0 0 0 0 0  0  0  0  0  0  0  0  0  0  0  0  0  
29        1 0 0 0 0 1 0 0 0 0 0  0  0  0  0  0  0  0  0  0  0  0  0  
30        1 0 0 0 0 0 1 0 0 0 0  0  0  0  0  1  0  0  0  0  0  0  0  
31        1 1 0 0 0 0 0 0 0 0 0  0  0  0  0  1  0  0  0  0  0  0  0  
32        1 0 1 0 0 0 0 0 0 0 0  0  0  0  0  1  0  0  0  0  0  0  0  
33        1 0 0 1 0 0 0 0 0 0 0  0  0  0  0  1  0  0  0  0  0  0  0  
34        1 0 0 0 1 0 0 0 0 0 0  0  0  0  0  1  0  0  0  0  0  0  0  
35        1 0 0 0 0 1 0 0 0 0 0  0  0  0  0  1  0  0  0  0  0  0  0  
36        1 0 0 0 0 0 1 0 0 0 0  0  0  0  0  0  1  0  0  0  0  0  0  
37        1 1 0 0 0 0 0 0 0 0 0  0  0  0  0  0  1  0  0  0  0  0  0  
38        1 0 1 0 0 0 0 0 0 0 0  0  0  0  0  0  1  0  0  0  0  0  0  
39        1 0 0 1 0 0 0 0 0 0 0  0  0  0  0  0  1  0  0  0  0  0  0  
40        1 0 0 0 1 0 0 0 0 0 0  0  0  0  0  0  1  0  0  0  0  0  0  
41        1 0 0 0 0 1 0 0 0 0 0  0  0  0  0  0  1  0  0  0  0  0  0  
42        1 0 0 0 0 0 1 0 0 0 0  0  0  0  0  1  1  0  0  0  0  0  0  
43        1 1 0 0 0 0 0 0 0 0 0  0  0  0  0  1  1  0  0  0  0  0  0  
44        1 0 1 0 0 0 0 0 0 0 0  0  0  0  0  1  1  0  0  0  0  0  0  
45        1 0 0 1 0 0 0 0 0 0 0  0  0  0  0  1  1  0  0  0  0  0  0  
46        1 0 0 0 1 0 0 0 0 0 0  0  1  0  0  1  1  0  0  0  0  0  0  
47        1 0 0 0 0 1 0 0 0 0 0  0  1  0  0  1  1  0  0  0  0  0  0  
48        1 0 0 0 0 0 1 0 0 0 0  0  1  0  0  0  0  1  0  0  0  0  0  
49        1 1 0 0 0 0 0 0 0 0 0  0  1  0  0  0  0  0  0  0  0  0  0  
50        1 0 1 0 0 0 0 0 0 0 0  0  1  0  0  0  0  0  0  0  0  0  0  
51        1 0 0 1 0 0 0 0 0 0 0  0  1  0  0  0  0  0  0  0  0  0  0  
52        1 0 0 0 1 0 0 0 0 0 0  0  0  0  0  0  0  0  0  0  0  0  0  
53        1 0 0 0 0 1 0 0 0 0 0  0  0  0  0  0  0  0  0  0  0  0  0  
54        1 0 0 0 0 0 1 0 0 0 0  0  0  0  0  1  0  0  0  0  0  0  0  
55        1 1 0 0 0 0 0 0 0 0 0  0  0  0  0  1  0  0  0  0  0  0  0  
56        1 0 1 0 0 0 0 0 0 0 0  0  0  0  0  1  0  0  0  0  0  0  0  
57        1 0 0 1 0 0 0 0 0 0 0  0  0  0  0  1  0  0  0  0  0  0  0  
58        1 0 0 0 1 0 0 0 0 0 0  0  0  0  0  1  0  0  0  0  0  0  0  
59        1 0 0 0 0 1 0 0 0 0 0  0  0  0  0  1  0  0  0  0  0  0  0  
60        1 0 0 0 0 0 1 0 0 0 0  0  0  0  0  0  1  0  0  0  0  0  0  
61        1 1 0 0 0 0 0 0 0 0 0  0  0  0  0  0  1  0  0  0  0  0  0  
62        1 0 1 0 0 0 0 0 0 0 0  0  0  0  0  0  1  0  0  0  0  0  0  
63        1 0 0 1 0 0 0 0 0 0 0  0  0  0  0  0  1  0  0  0  0  0  0  
64        1 0 0 0 1 0 0 0 0 0 0  0  0  0  0  0  1  0  0  0  0  0  0  
65        1 0 0 0 0 1 0 0 0 0 0  0  0  0  0  0  1  0  0  0  0  0  0  
66        1 0 0 0 0 0 1 0 0 0 0  0  0  0  0  1  1  0  0  0  0  0  0  
67        1 1 0 0 0 0 0 0 0 0 0  0  0  0  0  1  1  0  0  0  0  0  0  
68        1 0 1 0 0 0 0 0 0 0 0  0  0  0  0  1  1  0  0  0  0  0  0  
69        1 0 0 1 0 0 0 0 0 0 0  0  0  0  0  1  1  0  0  0  0  0  0  
70        1 0 0 0 1 0 0 0 0 0 0  0  1  0  0  1  1  0  0  0  0  0  0  
71        1 0 0 0 0 1 0 0 0 0 0  0  1  0  0  1  1  0  0  0  0  0  0  
72        1 0 0 0 0 0 1 0 0 0 0  0  1  0  0  0  0  1  0  0  0  0  0  
73        1 1 0 0 0 0 0 0 0 0 0  0  1  0  0  0  0  0  0  0  0  0  0  
74        1 0 1 0 0 0 0 0 0 0 0  0  1  0  0  0  0  0  0  0  0  0  0  
75        1 0 0 1 0 0 0 0 0 0 0  0  1  0  0  0  0  0  0  0  0  0  0  
76        1 0 0 0 1 0 0 0 0 0 0  0  0  0  0  0  0  0  0  0  0  0  0  
77        1 0 0 0 0 1 0 0 0 0 0  0  0  0  0  0  0  0  0  0  0  0  0  
78        1 0 0 0 0 0 1 0 0 0 0  0  0  0  0  1  0  0  0  0  0  0  0  
79        1 1 0 0 0 0 0 0 0 0 0  0  0  0  0  1  0  0  0  0  0  0  0  
80        1 0 1 0 0 0 0 0 0 0 0  0  0  0  0  1  0  0  0  0  0  0  0  
81        1 0 0 1 0 0 0 0 0 0 0  0  0  0  0  1  0  0  0  0  0  0  0  
82        1 0 0 0 1 0 0 0 0 0 0  0  0  0  0  1  0  0  0  0  0  0  0  
83        1 0 0 0 0 1 0 0 0 0 0  0  0  0  0  1  0  0  0  0  0  0  0  
84        1 0 0 0 0 0 1 0 0 0 0  0  0  0  0  0  1  0  0  0  0  0  0  
85        1 1 0 0 0 0 0 0 0 0 0  0  0  0  0  0  1  0  0  0  0  0  0  
86        1 0 1 0 0 0 0 0 0 0 0  0  0  0  0  0  1  0  0  0  0  0  0  
87        1 0 0 1 0 0 0 0 0 0 0  0  0  0  0  0  1  0  0  0  0  0  0  
88        1 0 0 0 1 0 0 0 0 0 0  0  0  0  0  0  1  0  0  0  0  0  0  
89        1 0 0 0 0 1 0 0 0 0 0  0  0  0  0  0  1  0  0  0  0  0  0  
90        1 0 0 0 0 0 1 0 0 0 0  0  0  0  0  1  1  0  0  0  0  0  0  
91        1 1 0 0 0 0 0 0 0 0 0  0  0  0  0  1  1  0  0  0  0  0  0  
92        1 0 1 0 0 0 0 0 0 0 0  0  0  0  0  1  1  0  0  0  0  0  0  
93        1 0 0 1 0 0 0 0 0 0 0  0  0  0  0  1  1  0  0  0  0  0  0  
94        1 0 0 0 1 0 0 0 0 0 0  0  1  0  0  1  1  0  0  0  0  0  0  
95        1 0 0 0 0 1 0 0 0 0 0  0  1  0  0  1  1  0  0  0  0  0  0  
96        1 0 0 0 0 0 1 0 0 0 0  0  1  0  0  0  0  1  0  0  0  0  0  
97        1 1 0 0 0 0 0 0 0 0 0  0  1  0  0  0  0  0  0  0  0  0  0  
98        1 0 1 0 0 0 0 0 0 0 0  0  1  0  0  0  0  0  0  0  0  0  0  
99        1 0 0 1 0 0 0 0 0 0 0  0  1  0  0  0  0  0  0  0  0  0  0  
100       1 0 0 0 1 0 0 0 0 0 0  0  0  0  0  0  0  0  0  0  0  0  0  
101       1 0 0 0 0 1 0 0 0 0 0  0  0  0  0  0  0  0  0  0  0  0  0  
102       1 0 0 0 0 0 1 0 0 0 0  0  0  0  0  1  0  0  0  0  0  0  0  
103       1 1 0 0 0 0 0 0 0 0 0  0  0  0  0  1  0  0  0  0  0  0  0  
104       1 0 1 0 0 0 0 0 0 0 0  0  0  0  0  1  0  0  0  0  0  0  0  
105       1 0 0 1 0 0 0 0 0 0 0  0  0  0  0  1  0  0  0  0  0  0  0  
106       1 0 0 0 1 0 0 0 0 0 0  0  0  0  0  1  0  0  0  0  0  0  0  
107       1 0 0 0 0 1 0 0 0 0 0  0  0  0  0  1  0  0  0  0  0  0  0  
108       1 0 0 0 0 0 1 0 0 0 0  0  0  0  0  0  1  0  0  0  0  0  0  
109       1 1 0 0 0 0 0 0 0 0 0  0  0  0  0  0  1  0  0  0  0  0  0  
110       1 0 1 0 0 0 0 0 0 0 0  0  0  0  0  0  1  0  0  0  0  0  0  
111       1 0 0 1 0 0 0 0 0 0 0  0  0  0  0  0  1  0  0  0  0  0  0  
